..&.........../............
..&/....../..//./....@././.
..&....../........../......
..&././/........../.././...
/.&....../..././..//./..///
..&..........-.........&&&&
..&.././/.../../././//.&./.
..&../../..............&...
..&.//../..///.....///-&/./
..&....................&...
.-&....................&...
&&&&&&&&&&&&&&&&&&&&&&&&&&&
........................&..
....../........../......&..
//.././.../..././..//...&./
..../............../....&./
/....//./......./..../..&..
/./.../....../../.......&./
........................&..
//.///././///.......///.&/.

