..................****/*/**
........../........//*****/
..-/.............//.*******
................./../***///
..........-......./********
.........../......./.@*/***
...................//**/***
...........****************
......*****..........///***
..****.............../*****
**.................../*****
........./..........././***
...................../.****
................-...../**/*
.............../....../****
.........-.............//**
..../....................//
...........................
........../........./......
...........................



