...........................
............@..............
........///........../.....
.//................///.....
............///.........//.
......///..............//..
...........................
...........................
...................../.....
........................./.
....///...../..............
.....-....../..............
...........//..............
...........-...............
.................//........
.......//..................
.......-....../........//..
............../.......-....
............../............
...........................



