*/***/*/****/*********//***
*/**.@******/**/**/***/****
*/**./**//*//**/***//****/*
*/*//***/****///**//***/***
*******//**/***/*****/***//
*/-./**/***/*///*//*//***.-
*////**/***/**/*/*///**//./
***********/****/********./
////////***////*/*/////*///
****.../***/****/****/***/*
*/***********/**/****//****
*//***//**/*****/*//-.//*/*
*/*****//*/***/*//*////****
//*/**/*///*////***/..///**
***/**********/***/***/***
*///***********/**//*******
*/..-/*/****/*//*****../***
*/////******/**/**//////***
*/***//*///****************
*/***/****/**////*******/**

