.../....../......../././-..
..-...-......../...........
/...../................/...
......//..//./../.../././..
//./../...//./.......////..
............@......./......
../..-//...././/.././/./...
...//............./../.....
.//...../........./........
.././/...././..././........
..///....//.../..-.-/...-..
././.../...././//..///.....
/............../......./...
....../...../....../.......
.....././...././......././/
-/...//....././............
.........././...../........
..../...../.././.../...../.
....././/..................
..//........../...../.././.
