./...../.../..../......./..
...//.../.../../-/...../../
........................./.
../...-..././.../.....//...
../.../././....../../......
........//....../.../..../.
....././././...........//..
...................../..../
............./.../......../
....././../......//.././...
.........//...-../..../....
./../.../....../../.....//.
......./................/..
.../.././..///././......-..
../.../.../.../....//../../
.../....../................
//..../....../......../..@.
//..../..././.-././......./
-/./....-../....../../.....
.././//.-././..//.././.....
